NO ./srcs/sprites/purplestone.png


SO   ./srcs/sprites/purplestone.png


WE ./srcs/sprites/wood.png
EA ./srcs/sprites/diamond.png


F 91,135,49


C 128,235,255



S   ./srcs/sprites/sprite_1.png
R 960  640






              1 1 1
        1 1 1 1 0 1 1 1 1 1
        1 0 0 0 0 0 0 1 1 1 1 1 1 1 1
1 1 1 1 1 0 0 0 0 1 0 1 1
1 0 0 0 0 0 0 1 1 0 0 0 1
1 0 0 0 0 1 0 1 1 0 0 0 1
1 0 0 1 1 1 0 0 0 1 1 1 1
1 1 1 1 0 1 1 0 0 0 0 0 1 1 1 1 1 1 1 1
1 1 0 0 0 0 0 0 0 0 0 0 0 0 0 0 0 0 0 1
1 2 0 0 0 0 2 0 0 2 0 0 0 N 0 0 0 0 0 1
1 1 0 0 0 0 0 0 0 0 0 0 0 0 0 0 0 0 0 1
1 0 0 0 0 0 0 0 0 0 0 0 0 0 0 0 0 0 0 1
1 0 0 1 0 1 0 0 0 0 0 0 0 0 0 0 0 0 0 1
1 1 1 1 1 1 1 1 1 1 1 1 1 1 1 1 1 1 1 1