NO ./srcs/sprites/wood.png


SO   ./srcs/sprites/diamond.png


WE ./srcs/sprites/wood3.png
EA ./srcs/sprites/diamond.png


F 91,135,49


C 128,235,255



S   ./path_to_the_sprite_texture
R 960  640






              1 1 1
        1 1 1 1 0 1 1 1 1 1
        1 0 0 0 0 0 0 1 1 1 1 1 1 1 1
1 1 1 1 1 0 0 0 0 1 0 1 1
1 0 0 0 0 0 0 1 1 0 0 0 1
1 0 0 0 0 1 0 1 1 0 0 0 1
1 0 0 1 1 1 0 0 0 1 1 1 1
1 1 1 1 0 1 1 0 0 0 0 0 1 1 1 1 1 1 1 1
1 0 0 0 0 0 0 0 0 0 0 0 0 0 0 0 0 0 0 1
1 0 0 0 0 0 2 0 0 0 0 0 0 0 0 0 0 0 0 1
1 0 0 0 0 0 0 0 0 0 0 0 0 0 0 0 0 0 0 1
1 0 0 0 0 0 0 0 0 0 0 0 0 0 0 0 0 0 0 1
1 0 0 0 0 0 0 N 0 0 0 0 0 0 0 0 0 0 0 1
1 1 1 1 1 1 1 1 1 1 1 1 1 1 1 1 1 1 1 1