
S ./path_to_sprite
R 1920      800   


WE ./path_to_the_west_texture   
NO ./path_to_north_texture
SO ./path_to_south_texture
EA ./path_to_east





1 1 1 1 1 1 1 1 1 1 1 1 1 1 1 1
1 0 0 0 0 0 0 0 N 0 0 0 1 1 1 1
1 0 0 0 0 0 0 1 1 1 1 1 1 1 1 1
1 0 0 1 1 0 0 0 0 1 1 1 1
1 0 0 1 1 0 0 1 0 1 1 1 1
1 0 0 1 1 0 0 0 0 1 1 1 1
1 1 1 1 1 1 1 1 1 1 1 1 1 
1 0 0 0 0 0 0 0 0 0 0 0 1 1 1 1
1 1 1 1 1 1 1 1 1 1 1 1 1 1 1 1