R 960  640

NO ./srcs/sprites/purplestone.png
SO   ./srcs/sprites/purplestone.png
WE ./srcs/sprites/wall_4.png
EA ./srcs/sprites/wall_4.png


F 112,128,144
C 47,79,79


S   ./srcs/sprites/sprite_1.png


              1 1 1
        1 1 1 1 0 1 1 1 1 1
        1 0 0 0 0 0 0 1 1 1 1 1 1 1 1
1 1 1 1 1 0 0 0 0 1 0 1 1
1 0 0 0 0 0 0 1 1 0 0 0 1
1 0 0 0 0 1 0 1 1 0 0 0 1
1 0 0 1 1 1 0 0 0 1 1 1 1
1 1 1 1 0 1 1 0 0 0 0 2 1 1 1 1 1 1 1 1
1 1 0 0 0 0 2 0 0 0 0 0 0 0 0 0 0 0 0 1
1 2 0 0 0 0 0 0 0 0 0 0 0 N 0 0 0 0 0 1
1 1 0 0 0 0 0 0 0 0 0 0 0 0 0 0 0 0 0 1
1 0 0 0 0 0 0 2 0 0 0 0 0 0 0 0 0 0 0 1
1 0 0 1 0 1 0 0 0 0 0 0 0 0 0 0 0 0 0 1
1 1 1 1 1 1 1 1 1 1 1 1 1 1 1 1 1 1 1 1